11111111111111
10C00100010101
1000P1C0000101
1C00000E111101
10000C00E0C001
11111111111111