11111111111111
11E10100010101
1111P1C0000101
1C00000C111101
10000C0000C001
11111111111111