11111111111111
10C00100010101
1000P1C0000101
1C00000E1111001
10000C0000C001
11111111111111